# Traducción oficial de P5R/P4G/P3P:
Follow-Up -> Ataque de Seguimiento
All-Out Attack -> Ataque combinado
Velvet Room -> Habitación Terciopelo
Support -> Apoyo
Buff -> Ventajas
Debuffs -> Desventajas
Wild Card -> Comodín
##
HP -> PS
SP -> PE
##
St -> Fr
Ma -> Ma
En -> Rs
Ag -> Ag
Lu -> Su
# Skills
Miniscule -> minúsculo
Light -> leve
Medium -> medio
Heavy -> grave
Severe -> severo
Colossal -> Colossal
Extreme -> Extremo
# Elements
Psy -> psicoquinético/psi.
# Abreviaturas:
Ataque -> Atq.
Precisión -> Prec.
Evasión -> Eva.
Probabilidad -> Prob.
# Arcanas
Hanged -> Ahorcado
Justice -> Justicia
Magi -> Mago
Fortune -> Fortuna
Chariot -> Carro
Fool -> Loco
Prsts -> Sacerdotisa
Death -> Muerte
Tower -> Torre
Judge -> Juicio
Devil -> Diablo
Sun -> Sol
Star -> Estrella
Hiero -> Hierofante
Emprs -> Emperatriz
Moon -> Luna
Lovers -> Amantes
Hermit -> Ermitaño
Temper -> Templanza
Str -> Fuerza
World -> Mundo
Emp -> Emperador

# Traducción oficial de Persona 5 Royal:
Baton Pass -> Relevo

# Traducción oficial de Persona 5 Tactica:
Sub-Persona -> Persona Secundaria
Navi -> Navi

# Traducción oficial de Persona 3 Portable:
Evoker -> Evocador

# Q2:
Lv -> Nv
Teasure Spot -> Punto de Tesoro
Boost -> Boost
Binds -> Ataduras
Hex -> Maldición
Persona Film -> Persona Film # Temporal
P-Book -> P-Book
Front Row -> Fila Frontal
Back Row -> Fila Trasera
Navi -> Nav. ?
Unison Skills -> Habilidades de Unión
Wanted -> Necesario
Ranged -> Distancia
Splash Damage -> Daño por Salpicadura
Self -> Propio
Party Meter -> Medidor de Grupo
## Historia:
the curator -> la conservadora
concession stand -> puesto de comida

